WWWWWWWWWWWWW
WWWLLLLLWWWWW
WWWLLLLLLLWWW
WWWLL@LLLLWWW
WWWWLLLLLWWWW
WWWWLLLLLWWWW
WWWWWWWWWWWWW
WWWWWWWWWWWWW
WWWWWWWWWWWWW


{
    "@": "player",
    "W": "water",
    "L": "land"
}